0 R 0 R 0 R 0 R 0 R 0 R 0 R 0 R 0 R 0 R 0 R 0 R 0 R 0 R 0 R 0 R 0 R 0 R 0 R 0 R
0 R 0 R 0 R 0 R 0 R 0 R 0 R 0 R 0 R 0 R 0 R 0 R 0 R 0 R 0 R 0 R 0 R 0 R 0 R 0 R
0 R 2 R 1 R 1 R 1 R 1 R 1 R 1 R 1 R 1 R 1 R 1 R 1 R 1 R 1 R 1 R 1 R 1 R 2 R 0 R
0 R 1 R 1 R 1 R 1 R 1 R 1 R 1 R 1 R 1 R 1 R 1 R 1 R 1 R 1 R 1 R 1 R 1 R 1 R 0 R
0 R 1 R 1 R 1 R 1 R 1 R 1 R 1 R 1 R 3 R 3 R 1 R 1 R 1 R 1 R 1 R 1 R 1 R 1 R 0 R
0 R 1 R 1 R 1 R 1 R 1 R 1 R 1 R 1 R 1 R 1 R 1 R 1 R 1 R 1 R 1 R 1 R 1 R 1 R 0 R
0 R 1 R 1 R 1 R 1 R 1 R 1 R 1 R 1 R 1 R 1 R 1 R 1 R 1 R 1 R 1 R 1 R 1 R 1 R 0 R
0 R 1 R 1 R 1 R 1 R 1 R 1 R 1 R 1 R 1 R 1 R 1 R 1 R 1 R 1 R 1 R 1 R 1 R 1 R 0 R
0 R 1 R 1 R 1 R 1 R 1 R 1 R 1 R 1 R 1 R 1 R 1 R 1 R 1 R 1 R 1 R 1 R 1 R 1 R 0 R
