0 0 0 0 0 0 0 0 0 0 0 0 0 0 0 0 0 0 0 0 0 0 0 0 0 0 0 0 0 0 0 0 0 0
0 0 1 3 0 0 0 0 0 0 0 0 0 0 0 0 1 4 0 0 0 0 0 0 0 0 0 0 0 0 1 3 0 0
0 0 1 3 1 3 1 3 0 0 0 0 0 0 1 4 0 0 1 4 0 0 0 0 0 0 1 3 1 3 1 3 0 0
0 0 1 3 1 0 1 0 1 3 0 0 1 4 0 0 0 0 0 0 1 4 0 0 1 3 1 0 1 0 1 3 0 0
0 0 1 3 1 0 1 0 1 0 1 3 0 0 0 0 5 0 0 0 0 0 1 3 1 0 1 0 1 0 1 3 0 0
0 0 1 3 6 0 1 0 1 0 1 0 1 3 0 0 0 0 0 0 1 3 1 0 1 0 1 0 6 0 1 3 0 0
0 0 1 3 2 3 1 0 1 0 1 0 1 0 1 3 0 0 1 3 1 0 1 0 1 0 1 0 2 3 1 3 0 0
0 0 1 3 1 0 1 0 1 0 1 0 1 0 1 0 1 3 1 0 1 0 1 0 1 0 1 0 1 0 1 3 0 0
0 0 1 3 1 0 1 0 1 0 1 0 1 0 1 0 1 0 1 0 1 0 1 0 1 0 1 0 1 0 1 3 0 0
0 0 1 3 1 0 1 0 1 0 1 0 1 0 1 0 0 0 1 0 1 0 1 0 1 0 1 0 1 0 1 3 0 0
0 0 1 3 1 0 4 0 1 2 1 0 1 0 0 0 2 3 0 0 1 0 1 0 1 2 4 0 1 0 1 3 0 0
0 0 1 3 1 0 2 3 0 0 1 0 1 0 1 0 0 0 1 0 1 0 1 0 0 0 2 3 1 0 1 3 0 0
0 0 1 3 1 0 1 0 0 0 1 0 1 0 1 0 1 2 1 0 1 0 1 0 0 0 1 0 1 0 1 3 0 0
0 0 1 3 1 0 1 0 0 0 1 0 1 0 1 2 0 0 1 2 1 0 1 0 0 0 1 0 1 0 1 3 0 0
0 0 1 3 1 0 1 0 0 0 1 0 1 2 0 0 0 0 0 0 1 2 1 0 0 0 1 0 1 0 1 3 0 0
