0 R 0 R 0 R 0 R 0 R 0 R 0 R 0 R 0 R 0 R 0 R 0 R 0 R 0 R 0 R 0 R 0 R 0 R 0 R 0 R
0 R 0 R 0 R 0 R 0 R 0 R 0 R 0 R 0 R 0 R 0 R 0 R 0 R 0 R 0 R 0 R 0 R 0 R 0 R 0 R
0 R 2 B 1 R 1 R 1 R 1 R 1 R 1 R 1 R 1 R 1 R 1 R 1 R 1 R 1 R 1 R 1 R 1 R 2 B 0 R
0 R 1 R 4 G 1 R 1 R 1 R 1 R 1 R 1 R 1 R 1 R 1 R 1 R 1 R 1 R 1 R 1 R 4 G 1 R 0 R
0 R 1 R 1 R 1 R 1 R 1 R 1 R 1 R 1 R 3 R 3 R 1 R 1 R 1 R 1 R 1 R 1 R 1 R 1 R 0 R
0 R 1 R 3 R 1 R 1 R 1 R 1 R 1 R 1 R 1 R 1 R 1 R 1 R 1 R 1 R 1 R 1 R 3 R 1 R 0 R
0 R 1 R 1 R 1 R 1 R 1 R 1 R 1 R 1 R 1 R 1 R 1 R 1 R 1 R 1 R 1 R 1 R 1 R 1 R 0 R
0 R 1 R 1 R 1 R 1 R 1 R 1 R 1 R 1 R 1 R 1 R 1 R 1 R 1 R 1 R 1 R 1 R 1 R 1 R 0 R
0 R 1 R 1 R 1 R 1 R 1 R 1 R 1 R 1 R 1 R 1 R 1 R 1 R 1 R 1 R 1 R 1 R 1 R 1 R 0 R
