1 0 1 1 1 2 1 0 1 1 1 2 1 0 1 1 1 2 1 0 1 1 1 2 1 0 1 1 1 2 1 0 1 1 1 2 1 0 1 1
1 2 1 0 1 1 1 2 1 0 1 1 1 2 1 0 1 1 1 2 1 0 1 1 1 2 1 0 1 1 1 2 1 0 1 1 1 2 1 0
1 1 1 2 1 0 1 1 1 2 1 0 1 1 1 2 1 0 1 1 1 2 1 0 1 1 1 2 1 0 1 1 1 2 1 0 1 1 1 2
1 0 1 1 1 2 1 0 1 1 1 2 1 0 1 1 1 2 1 0 1 1 1 2 1 0 1 1 1 2 1 0 1 1 1 2 1 0 1 1
1 2 1 0 1 1 1 2 1 0 1 1 1 2 1 0 1 1 1 2 1 0 1 1 1 2 1 0 1 1 1 2 1 0 1 1 1 2 1 0
1 1 1 2 1 0 1 1 1 2 1 0 1 1 1 2 1 0 1 1 1 2 1 0 1 1 1 2 1 0 1 1 1 2 1 0 1 1 1 2
1 0 1 1 1 2 1 0 1 1 1 2 1 0 1 1 1 2 1 0 1 1 1 2 1 0 1 1 1 2 1 0 1 1 1 2 1 0 1 1
1 2 1 0 1 1 1 2 1 0 1 1 1 2 1 0 1 1 1 2 1 0 1 1 1 2 1 0 1 1 1 2 1 0 1 1 1 2 1 0
1 1 1 2 1 0 1 1 1 2 1 0 1 1 1 2 1 0 1 1 1 2 1 0 1 1 1 2 1 0 1 1 1 2 1 0 1 1 1 2
4 0 5 1 6 2 4 0 5 1 6 2 4 0 5 1 6 2 4 0 5 1 6 2 4 0 5 1 6 2 4 0 5 1 6 2 4 0 5 1
